#,#,#,#,#,#,#,#
#,.,.,.,.,.,.,#
.,.,#,#,#,#,.,#
#,.,#,.,#,#,.,#
#,.,#,.,.,#,.,#
#,.,#,#,.,#,.,#
#,.,#,.,.,#,.,#
#,.,#,.,#,#,.,#
.,.,#,.,.,#,.,#
#,.,#,#,.,#,.,#
#,.,#,.,.,#,.,#
#,.,#,.,#,#,.,#
#,.,#,.,.,#,.,#
#,.,#,#,.,#,.,#
.,.,.,.,.,#,.,#

